#############**********************************@************
#---------◘##*************************@@@@@@@@@@@***********
#----------##*********************@@@@@@@@@@@@@@@@@@@@******
#----------##********************@@@@@@@@@@@@@@@@@@@@@@@****
#----------##*********************@@@@@@@@@@@@@@@@@@@@@@@@**
#----------##*********************@@@@@@@@@@@@@@@@@@@@@@@@**
#----------##***********************@@@@@@@@@@@@@@@@@@@@@***
#####  ######**************************@@@@@@@@@@@@@@@@@@***
******************************************@@@@@@@@@@@*******
************************************************************
************************************************************
************************************************************
************************************************************
************************************************************
************************************************************
************************************************************
************************************************************
************************************************************
************************************************************
************************************************************
************************************************************
************************************************************
************************************************************
************************************************************
************************************************************
************************************************************
************************************************************
************************************************************
************************************************************
************************************************************
